17 17 17 17 17 17 17 17 17 17 17 17 17 17 17 17 17 17
17 17 17 17 17 1 2 3 0 4 5 6 7 17 17 17 17 17
17 17 17 17 17 1 2 3 0 4 5 6 7 17 17 17 17 17
17 17 17 17 17 1 2 3 0 4 5 6 7 17 17 17 17 17
17 17 17 17 17 1 2 3 0 4 5 6 7 17 17 17 17 17
17 17 17 17 17 1 2 3 0 4 5 6 7 17 17 17 17 17
17 17 17 17 17 1 24 3 0 4 5 26 7 17 17 17 17 17
17 17 17 17 17 1 2 3 0 4 5 6 7 17 17 17 17 17
17 17 17 17 17 1 2 3 0 4 5 6 7 17 17 17 17 17
17 17 17 17 17 1 25 3 0 4 5 23 7 17 17 17 17 17
17 17 17 17 17 1 2 3 0 4 5 6 7 17 17 17 17 17
17 17 17 17 17 1 2 3 0 4 5 6 7 17 17 17 17 17
17 17 17 17 17 1 2 3 0 4 5 6 7 17 17 17 17 17
17 17 17 17 17 1 2 3 0 4 5 6 7 17 17 17 17 17
17 17 17 17 17 1 2 3 0 4 5 6 7 17 17 17 17 17
17 17 17 17 17 1 2 3 0 4 5 6 7 17 17 17 17 17
17 17 17 17 17 1 8 9 10 4 5 6 7 17 17 17 17 17
17 17 17 17 17 1 11 12 13 4 5 6 7 17 17 17 17 17
17 17 17 17 17 1 14 15 16 4 5 6 7 17 17 17 17 17
17 17 17 17 17 1 2 3 0 4 5 6 7 17 17 17 17 17
17 17 17 17 17 1 2 3 0 4 5 6 7 17 17 17 17 17
17 17 17 17 17 1 2 3 0 4 5 6 7 17 17 17 17 17
17 17 17 17 17 1 2 3 0 4 5 6 7 17 17 17 17 17
17 17 17 17 17 1 2 3 0 4 5 6 7 17 17 17 17 17
17 17 17 17 17 1 2 3 0 4 5 6 7 17 17 17 17 17
17 17 17 17 17 1 2 3 0 4 5 6 7 17 17 17 17 17
17 17 17 17 17 1 2 3 0 4 5 6 7 17 17 17 17 17
17 17 17 17 17 1 2 3 0 4 5 6 7 17 17 17 17 17
17 17 17 17 17 1 2 3 0 4 5 6 7 17 17 17 17 17
17 17 17 17 17 1 2 3 0 4 5 6 7 17 17 17 17 17
17 17 17 17 17 1 2 3 0 4 5 6 7 17 17 17 17 17
17 17 17 17 17 1 2 3 0 4 5 6 7 17 17 17 17 17
17 17 17 17 17 1 2 3 0 4 5 6 7 17 17 17 17 17
17 17 17 17 17 1 2 3 0 4 5 6 7 17 17 17 17 17
17 17 17 17 17 1 2 3 0 4 5 6 7 17 17 17 17 17
17 17 17 17 17 1 2 3 0 4 5 6 7 17 17 17 17 17
17 17 17 17 17 19 20 3 0 4 21 22 7 17 17 17 17 17
17 17 17 17 17 1 2 3 0 4 5 6 7 17 17 17 17 17
17 17 17 17 17 1 2 3 0 4 5 6 7 17 17 17 17 17
17 17 17 17 17 1 2 3 0 4 5 6 7 17 17 17 17 17
17 17 17 17 17 1 2 3 0 4 5 6 7 17 17 17 17 17
17 17 17 17 17 1 2 3 0 4 5 6 7 17 17 17 17 17
17 17 17 17 17 1 2 3 0 4 5 6 7 17 17 17 17 17
17 17 17 17 17 1 2 3 0 4 5 6 7 17 17 17 17 17
17 17 17 17 17 1 2 3 0 4 5 6 7 17 17 17 17 17
17 17 17 17 17 1 2 3 0 4 5 6 7 17 17 17 17 17
17 17 17 17 17 1 2 3 0 4 5 6 7 17 17 17 17 17
17 17 17 17 17 1 2 3 0 4 5 6 7 17 17 17 17 17
17 17 17 17 17 1 2 3 0 4 5 6 7 17 17 17 17 17
17 17 17 17 17 17 17 17 17 17 17 17 17 17 17 17 17 17