17 17 17 17 17 17 17 17 17 17 17 17 17 17 17 17 17 17
17 17 17 17 17 1 2 3 0 4 5 6 7 17 17 17 17 17
17 17 17 17 17 1 2 3 0 4 5 6 7 17 17 17 17 17
17 17 17 17 17 1 2 3 0 4 5 6 7 17 17 17 17 17
17 17 17 17 17 1 2 3 0 4 5 6 7 17 17 17 17 17
17 17 17 17 17 1 2 3 0 4 5 6 7 17 17 17 17 17
17 17 17 17 17 1 2 3 0 4 5 6 7 17 17 17 17 17
17 17 17 17 17 1 2 3 0 4 5 6 7 17 17 17 17 17
17 17 17 17 17 1 2 3 0 4 5 6 7 17 17 17 17 17
17 17 17 17 17 1 2 3 0 4 5 6 7 17 17 17 17 17
17 17 17 17 17 1 2 3 0 4 5 6 7 17 17 17 17 17
17 17 17 17 17 1 2 3 0 4 5 6 7 17 17 17 17 17
17 17 17 17 17 1 2 3 0 4 5 6 7 17 17 17 17 17
17 17 17 17 17 1 2 3 0 4 5 6 7 17 17 17 17 17
17 17 17 17 17 1 2 3 0 4 5 6 7 17 17 17 17 17
17 17 17 17 17 1 2 3 0 4 5 6 7 17 17 17 17 17
17 17 17 17 17 1 8 9 10 4 5 6 7 17 17 17 17 17
17 17 17 17 17 1 11 12 13 4 5 6 7 17 17 17 17 17
17 17 17 17 17 1 14 15 16 4 5 6 7 17 17 17 17 17
17 17 17 17 17 1 2 3 0 4 5 6 7 17 17 17 17 17
17 17 17 17 17 1 2 3 0 4 5 6 7 17 17 17 17 17
17 17 17 17 17 1 2 3 0 4 5 6 7 17 17 17 17 17
17 17 17 17 17 1 2 3 0 4 5 6 7 17 17 17 17 17
17 17 17 17 17 1 2 3 0 4 5 6 7 17 17 17 17 17
17 17 17 17 17 1 2 3 0 4 5 6 7 17 17 17 17 17
17 17 17 17 17 1 2 3 0 4 5 6 7 17 17 17 17 17
17 17 17 17 17 1 2 3 0 4 5 6 7 17 17 17 17 17
17 17 17 17 17 1 2 3 0 4 5 6 7 17 17 17 17 17
17 17 17 17 17 1 2 3 0 4 5 6 7 17 17 17 17 17
17 17 17 17 17 1 2 3 0 4 5 6 7 17 17 17 17 17
17 17 17 17 17 1 2 3 0 4 5 6 7 17 17 17 17 17
17 17 17 17 17 1 2 3 0 4 5 6 7 17 17 17 17 17
17 17 17 17 17 1 2 3 0 4 5 6 7 17 17 17 17 17
17 17 17 17 17 1 2 3 0 4 5 6 7 17 17 17 17 17
17 17 17 17 17 1 2 3 0 4 5 6 7 17 17 17 17 17
17 17 17 17 17 1 2 3 0 4 5 6 7 17 17 17 17 17
17 17 17 17 17 1 2 3 0 4 5 6 7 17 17 17 17 17
17 17 17 17 17 1 2 3 0 4 5 6 7 17 17 17 17 17
17 17 17 17 17 1 2 3 0 4 5 6 7 17 17 17 17 17
17 17 17 17 17 1 2 3 0 4 5 6 7 17 17 17 17 17
17 17 17 17 17 1 2 3 0 4 5 6 7 17 17 17 17 17
17 17 17 17 17 1 2 3 0 4 5 6 7 17 17 17 17 17
17 17 17 17 17 1 2 3 0 4 5 6 7 17 17 17 17 17
17 17 17 17 17 1 2 3 0 4 5 6 7 17 17 17 17 17
17 17 17 17 17 1 2 3 0 4 5 6 7 17 17 17 17 17
17 17 17 17 17 1 2 3 0 4 5 6 7 17 17 17 17 17
17 17 17 17 17 1 2 3 0 4 5 6 7 17 17 17 17 17
17 17 17 17 17 1 2 3 0 4 5 6 7 17 17 17 17 17
17 17 17 17 17 1 2 3 0 4 5 6 7 17 17 17 17 17
17 17 17 17 17 17 17 17 17 17 17 17 17 17 17 17 17 17