4 4 4 4 4 4 4 4 4 4 4 4 1 4 4 4 1 4 4 1 1 4 4 4 3 3 4 4 4 4 4 4 4 4 4
4 4 4 4 4 1 4 4 4 4 4 4 1 6 4 3 3 4 4 4 4 4 4 4 3 3 3 3 4 1 7 8 1 1 4 4
1 4 4 4 4 3 3 3 3 3 3 5 5 4 1 4 4 3 3 3 3 3 3 3 3 3 3 3 4 1 1 1 4 1 1 4
4 4 4 4 4 3 4 4 4 4 3 4 1 1 1 4 4 3 4 4 4 1 4 4 4 3 3 4 1 3 3 3 3 3 4 4
4 4 4 5 4 3 4 5 5 5 3 4 6 5 4 3 3 3 4 1 1 1 1 1 4 1 4 1 1 3 4 4 4 3 4 4
1 4 4 4 1 3 4 1 3 3 3 4 1 1 1 3 4 1 1 4 1 3 3 3 3 3 3 3 3 3 4 4 4 3 1 4
1 4 4 6 4 3 1 5 3 4 4 6 1 1 4 3 1 7 8 1 3 3 4 1 4 1 1 4 4 4 4 4 4 3 1 4
4 4 4 4 4 3 4 1 3 3 3 3 3 3 3 3 4 1 4 1 3 4 1 1 1 1 1 1 1 1 4 4 4 3 4 4
4 4 4 3 3 3 4 4 4 4 4 6 6 4 1 6 1 4 1 1 3 1 1 4 3 3 3 3 3 3 3 3 3 3 4 4
4 4 4 3 4 4 4 1 4 4 4 6 6 4 6 1 4 1 4 4 3 1 1 4 3 4 4 7 8 4 4 4 4 4 4 4
4 4 4 3 4 5 5 5 5 3 3 3 3 3 3 3 3 3 3 3 3 1 1 4 3 4 4 4 4 7 8 4 4 4 4 4
4 4 4 3 4 1 1 4 4 3 4 4 4 1 1 1 1 4 1 1 1 4 1 1 3 3 3 3 3 3 3 4 4 4 4 4
4 4 4 3 4 4 3 3 3 3 3 4 1 5 6 1 4 1 1 6 6 7 8 1 1 1 1 4 4 4 3 4 4 4 4 4
4 4 4 3 4 4 3 4 4 4 4 1 1 1 1 1 1 4 1 1 1 1 1 4 6 6 1 1 1 4 3 3 3 4 4 4
4 4 4 3 3 3 3 4 5 1 4 3 3 3 3 3 3 3 3 3 3 3 3 1 4 1 4 4 4 4 4 4 3 4 4 4
4 4 4 4 4 4 4 4 1 6 1 3 4 4 4 4 4 4 4 4 4 4 3 3 3 3 3 3 3 4 1 4 3 4 4 4
4 4 4 4 4 4 4 4 4 1 4 3 4 4 4 4 4 4 4 4 4 4 1 4 1 1 4 4 3 1 4 4 3 4 4 4
4 4 3 3 3 3 3 3 4 1 4 3 3 3 3 3 3 4 4 4 4 4 4 1 4 4 1 4 3 4 4 4 3 4 4 4
4 4 3 4 4 4 4 3 4 4 4 4 4 4 4 4 3 4 4 3 3 3 3 3 3 3 1 4 3 4 4 4 3 4 4 4
4 4 3 4 1 1 1 3 3 3 3 3 3 3 3 3 3 4 1 3 4 4 4 4 4 3 4 4 3 4 4 4 3 4 4 4
4 4 3 4 6 6 1 1 1 1 1 1 1 4 1 4 4 1 4 3 4 7 8 1 4 3 4 4 3 4 4 4 3 4 4 4
4 4 3 1 1 1 4 6 6 6 6 4 4 4 4 1 4 4 4 3 4 1 7 8 4 3 4 4 3 4 4 4 3 4 4 4
4 4 3 4 7 8 1 1 1 4 3 3 3 3 3 3 3 3 3 3 4 1 1 4 3 3 4 4 3 4 4 4 3 4 4 4
4 4 3 1 1 1 4 4 4 1 3 4 4 4 4 4 4 4 4 4 4 1 4 4 3 4 4 4 3 4 4 4 3 4 4 4
4 4 3 1 6 1 1 1 1 3 3 1 1 1 1 1 1 1 4 4 1 1 4 3 3 1 4 3 3 4 4 4 3 4 4 4
4 4 3 3 3 3 3 4 4 3 4 4 4 1 1 1 4 4 1 1 1 4 1 3 4 4 4 3 4 1 1 1 3 4 4 4
4 4 4 4 4 4 3 4 4 3 4 6 1 1 1 4 4 1 4 4 4 4 4 3 4 4 4 3 4 1 4 1 3 4 4 4
4 4 4 4 3 3 3 4 4 3 4 1 1 1 4 4 3 3 3 3 3 3 3 3 4 4 4 3 1 5 4 3 3 4 4 4
4 4 4 4 3 4 5 5 5 3 4 1 1 4 4 4 3 4 4 4 4 4 4 4 4 4 4 3 4 6 1 3 4 4 4 4
4 4 4 4 3 1 7 8 4 3 4 1 1 4 4 4 3 4 4 4 1 1 4 4 3 3 3 3 4 1 1 3 4 4 4 4
4 4 4 4 3 4 4 1 4 3 4 1 1 1 4 4 3 4 4 7 8 4 4 3 3 1 1 4 1 1 4 3 4 4 4 4
4 4 3 3 3 5 5 4 1 3 4 1 1 7 8 4 3 4 4 1 1 4 4 3 4 1 5 1 7 8 1 3 4 4 4 4
4 4 3 4 4 1 4 1 4 3 4 5 1 4 1 4 3 4 4 4 1 4 4 3 1 6 1 1 1 1 1 3 4 4 4 4
4 4 3 4 1 1 1 5 1 3 4 1 6 1 1 4 3 4 1 4 1 1 4 3 1 5 6 4 5 3 3 3 4 4 4 4
4 4 3 5 5 4 4 1 4 3 4 4 1 1 4 3 3 3 4 1 4 1 4 3 4 4 5 1 4 3 4 4 4 4 4 4
4 4 3 3 3 3 3 3 3 3 4 1 1 1 4 3 3 3 4 4 1 4 4 3 3 3 3 3 3 3 4 4 4 4 4 4
4 4 4 4 4 4 4 4 4 4 4 4 4 4 4 3 3 3 4 4 4 4 4 4 4 4 4 4 4 4 4 4 4 4 4 4
4 4 4 4 4 4 4 4 4 4 4 4 4 4 4 4 4 4 4 4 4 4 4 4 4 4 4 4 4 4 4 4 4 4 4 4
4 4 4 4 4 4 4 4 4 4 4 4 4 4 4 4 4 4 4 4 4 4 4 4 4 4 4 4 4 4 4 4 4 4 4 4
4 4 4 4 4 4 4 4 4 4 4 4 4 4 4 4 4 4 4 4 4 4 4 4 4 4 4 4 4 4 4 4 4 4 4 4
4 4 4 4 4 4 4 4 4 4 4 4 4 4 4 4 4 4 4 4 4 4 4 4 4 4 4 4 4 4 4 4 4 4 4 4
4 4 4 4 4 4 4 4 4 4 4 4 4 4 4 4 4 4 4 4 4 4 4 4 4 4 4 4 4 4 4 4 4 4 4 4
4 4 4 4 4 4 4 4 4 4 4 4 4 4 4 4 4 4 4 4 4 4 4 4 4 4 4 4 4 4 4 4 4 4 4 4
4 4 4 4 4 4 4 4 4 4 4 4 4 4 4 4 4 4 4 4 4 4 4 4 4 4 4 4 4 4 4 4 4 4 4 4
4 4 4 4 4 4 4 4 4 4 4 4 4 4 4 4 4 4 4 4 4 4 4 4 4 4 4 4 4 4 4 4 4 4 4 4
4 4 4 4 4 4 4 4 4 4 4 4 4 4 4 4 4 4 4 4 4 4 4 4 4 4 4 4 4 4 4 4 4 4 4 4
4 4 4 4 4 4 4 4 4 4 4 4 4 4 4 4 4 4 4 4 4 4 4 4 4 4 4 4 4 4 4 4 4 4 4 4
4 4 4 4 4 4 4 4 4 4 4 4 4 4 4 4 4 4 4 4 4 4 4 4 4 4 4 4 4 4 4 4 4 4 4 4
4 4 4 4 4 4 4 4 4 4 4 4 4 4 4 4 4 4 4 4 4 4 4 4 4 4 4 4 4 4 4 4 4 4 4 4
4 4 4 4 4 4 4 4 4 4 4 4 4 4 4 4 4 4 4 4 4 4 4 4 4 4 4 4 4 4 4 4 4 4 4 4