4 4 4 4 4 4 4 4 4 4 4 4 4 0 4 4 4 0 4 4 0 0 4 4 4 3 3 4 4 4 4 4 4 4 4 4
4 4 4 4 4 0 4 4 4 4 4 4 0 6 4 3 3 4 4 4 4 4 4 4 3 3 3 3 4 0 7 8 0 0 4 4
0 4 4 4 4 3 3 3 3 3 3 5 5 4 0 4 4 3 3 3 3 3 3 3 3 3 3 3 4 0 0 0 4 0 0 4
4 4 4 4 4 3 4 4 4 4 3 4 0 0 0 4 4 3 4 4 4 0 4 4 4 3 3 4 0 3 3 3 3 3 4 4
4 4 4 5 4 3 4 5 5 5 3 4 6 5 4 3 3 3 4 0 0 0 0 0 4 0 4 0 0 3 4 4 4 3 4 4
0 4 4 4 0 3 4 0 3 3 3 4 0 0 0 3 4 0 0 4 0 3 3 3 3 3 3 3 3 3 4 4 4 3 0 4
0 4 4 6 4 3 0 5 3 4 4 6 0 0 4 3 0 7 8 0 3 3 4 0 4 0 0 4 4 4 4 4 4 3 0 4
4 4 4 4 4 3 4 0 3 3 3 3 3 3 3 3 4 0 4 0 3 4 0 0 0 0 0 0 0 0 4 4 4 3 4 4
4 4 4 3 3 3 4 4 4 4 4 6 6 4 0 6 0 4 0 0 3 0 0 4 3 3 3 3 3 3 3 3 3 3 4 4
4 4 4 3 4 4 4 0 4 4 4 6 6 4 6 0 4 0 4 4 3 0 0 4 3 4 4 7 8 4 4 4 4 4 4 4
4 4 4 3 4 5 5 5 5 3 3 3 3 3 3 3 3 3 3 3 3 0 0 4 3 4 4 4 4 7 8 4 4 4 4 4
4 4 4 3 4 0 0 4 4 3 4 4 4 0 0 0 0 4 0 0 0 4 0 0 3 3 3 3 3 3 3 4 4 4 4 4
4 4 4 3 4 4 3 3 3 3 3 4 0 5 6 0 4 0 0 6 6 7 8 0 0 0 0 4 4 4 3 4 4 4 4 4
4 4 4 3 4 4 3 4 4 4 4 0 0 0 0 0 0 4 0 0 0 0 0 4 6 6 0 0 0 4 3 3 3 4 4 4
4 4 4 3 3 3 3 4 5 0 4 3 3 3 3 3 3 3 3 3 3 3 3 0 4 0 4 4 4 4 4 4 3 4 4 4
4 4 4 4 4 4 4 4 0 6 0 3 4 4 4 4 4 4 4 4 4 4 3 3 3 3 3 3 3 4 0 4 3 4 4 4
4 4 4 4 4 4 4 4 4 0 4 3 4 4 4 4 4 4 4 4 4 4 0 4 0 0 4 4 3 0 4 4 3 4 4 4
4 4 3 3 3 3 3 3 4 0 4 3 3 3 3 3 3 4 4 4 4 4 4 0 4 4 0 4 3 4 4 4 3 4 4 4
4 4 3 4 4 4 4 3 4 4 4 4 4 4 4 4 3 4 4 3 3 3 3 3 3 3 0 4 3 4 4 4 3 4 4 4
4 4 3 4 0 0 0 3 3 3 3 3 3 3 3 3 3 4 0 3 4 4 4 4 4 3 4 4 3 4 4 4 3 4 4 4
4 4 3 4 6 6 0 0 0 0 0 0 0 4 0 4 4 0 4 3 4 7 8 0 4 3 4 4 3 4 4 4 3 4 4 4
4 4 3 0 0 0 4 6 6 6 6 4 4 4 4 0 4 4 4 3 4 0 7 8 4 3 4 4 3 4 4 4 3 4 4 4
4 4 3 4 7 8 0 0 0 4 3 3 3 3 3 3 3 3 3 3 4 0 0 4 3 3 4 4 3 4 4 4 3 4 4 4
4 4 3 0 0 0 4 4 4 0 3 4 4 4 4 4 4 4 4 4 4 0 4 4 3 4 4 4 3 4 4 4 3 4 4 4
4 4 3 0 6 0 0 0 0 3 3 0 0 0 0 0 0 0 4 4 0 0 4 3 3 0 4 3 3 4 4 4 3 4 4 4
4 4 3 3 3 3 3 4 4 3 4 4 4 0 0 0 4 4 0 0 0 4 0 3 4 4 4 3 4 0 0 0 3 4 4 4
4 4 4 4 4 4 3 4 4 3 4 6 0 0 0 4 4 0 4 4 4 4 4 3 4 4 4 3 4 0 4 0 3 4 4 4
4 4 4 4 3 3 3 4 4 3 4 0 0 0 4 4 3 3 3 3 3 3 3 3 4 4 4 3 0 5 4 3 3 4 4 4
4 4 4 4 3 4 5 5 5 3 4 0 0 4 4 4 3 4 4 4 4 4 4 4 4 4 4 3 4 6 0 3 4 4 4 4
4 4 4 4 3 0 7 8 4 3 4 0 0 4 4 4 3 4 4 4 0 0 4 4 3 3 3 3 4 0 0 3 4 4 4 4
4 4 4 4 3 4 4 0 4 3 4 0 0 0 4 4 3 4 4 7 8 4 4 3 3 0 0 4 0 0 4 3 4 4 4 4
4 4 3 3 3 5 5 4 0 3 4 0 0 7 8 4 3 4 4 0 0 4 4 3 4 0 5 0 7 8 0 3 4 4 4 4
4 4 3 4 4 0 4 0 4 3 4 5 0 4 0 4 3 4 4 4 0 4 4 3 0 6 0 0 0 0 0 3 4 4 4 4
4 4 3 4 0 0 0 5 0 3 4 0 6 0 0 4 3 4 0 4 0 0 4 3 0 5 6 4 5 3 3 3 4 4 4 4
4 4 3 5 5 4 4 0 4 3 4 4 0 0 4 3 3 3 4 0 4 0 4 3 4 4 5 0 4 3 4 4 4 4 4 4
4 4 3 3 3 3 3 3 3 3 4 0 0 0 4 3 3 3 4 4 0 4 4 3 3 3 3 3 3 3 4 4 4 4 4 4
4 4 4 4 4 4 4 4 4 4 4 4 4 4 4 3 3 3 4 4 4 4 4 4 4 4 4 4 4 4 4 4 4 4 4 4
4 4 4 4 4 4 4 4 4 4 4 4 4 4 4 4 4 4 4 4 4 4 4 4 4 4 4 4 4 4 4 4 4 4 4 4
4 4 4 4 4 4 4 4 4 4 4 4 4 4 4 4 4 4 4 4 4 4 4 4 4 4 4 4 4 4 4 4 4 4 4 4
4 4 4 4 4 4 4 4 4 4 4 4 4 4 4 4 4 4 4 4 4 4 4 4 4 4 4 4 4 4 4 4 4 4 4 4
4 4 4 4 4 4 4 4 4 4 4 4 4 4 4 4 4 4 4 4 4 4 4 4 4 4 4 4 4 4 4 4 4 4 4 4
4 4 4 4 4 4 4 4 4 4 4 4 4 4 4 4 4 4 4 4 4 4 4 4 4 4 4 4 4 4 4 4 4 4 4 4
4 4 4 4 4 4 4 4 4 4 4 4 4 4 4 4 4 4 4 4 4 4 4 4 4 4 4 4 4 4 4 4 4 4 4 4
4 4 4 4 4 4 4 4 4 4 4 4 4 4 4 4 4 4 4 4 4 4 4 4 4 4 4 4 4 4 4 4 4 4 4 4
4 4 4 4 4 4 4 4 4 4 4 4 4 4 4 4 4 4 4 4 4 4 4 4 4 4 4 4 4 4 4 4 4 4 4 4
4 4 4 4 4 4 4 4 4 4 4 4 4 4 4 4 4 4 4 4 4 4 4 4 4 4 4 4 4 4 4 4 4 4 4 4
4 4 4 4 4 4 4 4 4 4 4 4 4 4 4 4 4 4 4 4 4 4 4 4 4 4 4 4 4 4 4 4 4 4 4 4
4 4 4 4 4 4 4 4 4 4 4 4 4 4 4 4 4 4 4 4 4 4 4 4 4 4 4 4 4 4 4 4 4 4 4 4
4 4 4 4 4 4 4 4 4 4 4 4 4 4 4 4 4 4 4 4 4 4 4 4 4 4 4 4 4 4 4 4 4 4 4 4
4 4 4 4 4 4 4 4 4 4 4 4 4 4 4 4 4 4 4 4 4 4 4 4 4 4 4 4 4 4 4 4 4 4 4 4